3 3 3 3 3 3 3 3 0 0 0 0 0 0 0 0 0 0 0 0 0 0 9 0 3 3 3 4 4 0 0 4 4 4 4 3 3 9 0 0 0 0 0 0 0 0 0 0 0 0 0 0 3 3 3 3 3 3 3 3
3 3 0 0 3 3 3 3 3 3 0 0 0 0 0 0 0 0 0 0 0 0 0 0 0 3 3 4 4 0 0 4 4 4 4 3 3 0 0 0 0 0 0 3 3 0 0 0 0 0 3 3 3 3 3 3 3 3 0 0
3 3 0 0 3 3 3 4 4 0 0 0 0 0 4 4 0 0 0 5 0 0 0 0 0 0 0 0 0 0 0 0 0 0 0 0 0 0 0 0 0 0 3 3 3 0 0 0 0 0 4 4 4 3 3 3 3 3 0 0
3 3 3 3 3 3 3 4 4 0 0 0 3 3 4 4 5 0 0 0 0 0 0 0 0 0 0 0 0 0 0 0 0 0 0 0 0 0 0 0 0 0 5 3 3 0 0 0 0 0 4 4 4 3 3 3 3 3 3 3
3 3 3 3 3 3 3 4 4 0 0 0 3 3 4 4 3 0 0 0 0 3 3 0 0 0 0 0 0 0 0 0 0 0 0 0 0 0 0 0 0 0 0 0 3 3 0 0 0 0 0 4 4 3 3 3 3 3 3 3
3 3 4 4 3 3 0 0 0 0 0 0 0 3 3 3 3 0 0 0 0 5 3 0 0 0 0 0 0 0 0 0 0 0 0 0 0 0 0 0 0 0 0 0 0 3 0 0 0 0 3 3 0 0 0 3 3 4 4 3
0 3 4 4 5 0 0 0 0 0 0 0 0 0 0 0 0 0 0 0 0 0 0 0 0 0 0 0 0 0 0 0 0 0 0 0 0 0 0 0 0 0 0 0 0 0 0 0 0 0 0 0 0 0 0 0 0 4 4 3
0 3 4 4 0 0 0 0 0 0 0 0 0 0 0 0 0 0 0 0 0 0 0 0 0 0 0 0 0 0 0 0 0 0 0 0 0 0 0 0 0 0 0 0 0 0 0 0 0 0 0 0 0 0 0 0 0 4 4 3
0 3 4 4 0 0 0 0 0 0 6 6 6 6 6 6 6 6 6 6 6 6 6 6 6 6 6 6 6 0 0 6 6 6 6 6 6 6 6 6 6 6 6 6 6 6 6 6 6 6 0 0 0 0 0 0 0 4 4 0
0 0 0 0 0 0 0 0 0 0 0 0 6 6 6 0 0 0 0 0 0 6 0 0 0 0 0 0 0 0 0 0 0 0 3 3 0 0 0 3 6 6 6 0 0 0 6 6 0 0 0 0 0 0 0 0 0 0 0 0
0 0 0 0 0 0 0 0 0 0 0 0 6 6 6 0 0 0 0 0 0 6 0 0 3 3 0 0 0 0 0 0 0 0 0 0 0 0 0 3 3 0 0 0 0 0 0 0 0 0 0 0 0 0 0 0 0 0 0 0
0 0 0 0 0 0 0 6 0 0 0 0 6 3 3 0 0 6 6 0 0 0 0 0 3 6 6 0 0 0 0 0 0 0 0 6 6 0 0 0 0 0 0 0 0 0 0 0 3 3 0 0 0 6 0 0 3 3 5 0
5 3 0 0 0 0 0 6 0 0 0 0 6 0 0 0 0 6 3 0 0 0 0 0 0 6 0 0 0 0 3 6 6 0 0 0 0 0 0 6 6 0 0 6 6 0 0 6 6 6 0 0 6 0 0 3 4 4 0 0
3 3 3 3 0 0 0 6 6 6 0 0 6 0 0 0 0 6 3 0 0 6 0 0 0 0 0 0 0 0 3 6 6 0 0 0 0 0 0 0 0 0 0 0 6 0 0 0 0 0 0 0 6 0 0 3 4 4 0 0
3 3 3 3 0 0 0 0 6 6 6 0 0 0 0 0 0 0 6 0 0 0 6 6 0 0 0 0 0 6 0 3 6 0 0 0 3 6 0 0 0 0 0 0 0 6 0 0 0 0 0 0 0 6 0 0 3 4 4 0
3 3 5 0 0 0 0 6 7 0 0 0 0 0 0 0 0 0 0 0 0 0 6 6 0 0 6 6 6 0 0 0 0 0 0 3 6 6 6 0 0 0 0 0 0 0 0 6 6 6 3 3 6 0 0 0 0 4 4 0
3 3 0 0 0 0 0 6 7 0 3 3 0 0 0 0 0 0 0 0 0 0 0 0 0 0 0 0 0 0 0 0 0 0 0 0 0 0 0 0 0 0 3 3 0 0 0 6 0 3 3 3 6 0 0 0 0 0 0 0
3 3 0 0 0 0 3 6 6 6 6 3 0 6 0 0 6 6 6 0 0 0 0 0 0 0 0 0 0 0 0 0 6 6 0 0 0 0 0 0 0 6 6 6 6 0 0 6 0 0 3 3 6 0 0 0 0 0 0 0
0 0 0 0 0 0 3 6 6 6 6 0 0 6 0 0 6 3 3 3 3 6 6 0 0 6 0 0 0 6 0 0 0 6 0 0 0 0 0 0 0 0 6 0 0 0 0 0 0 0 6 6 6 0 0 0 3 0 0 0
9 0 4 4 4 0 0 6 0 0 0 0 0 0 0 0 0 0 0 0 3 3 6 6 6 6 6 0 0 6 0 0 7 7 6 0 0 0 6 0 0 0 0 0 0 0 0 0 0 0 0 3 6 6 0 0 3 3 3 0
0 0 4 4 4 0 0 6 0 0 0 0 0 0 0 0 0 0 0 0 6 6 6 6 6 6 6 6 6 6 0 0 6 6 6 6 6 6 6 6 6 0 0 0 0 0 6 6 6 0 0 3 6 6 0 0 5 3 3 0
0 0 0 4 4 0 0 6 6 3 0 0 0 0 0 6 0 0 0 6 6 7 7 0 0 0 0 0 0 0 0 0 0 0 0 0 0 0 7 7 6 0 0 0 6 6 6 0 0 0 0 0 3 6 6 0 0 0 0 0
0 0 0 4 4 0 0 6 6 3 0 6 0 0 0 6 6 0 0 0 6 7 0 0 0 0 0 0 0 0 0 0 0 0 0 0 0 0 0 7 6 6 0 0 6 0 0 0 0 0 0 0 0 0 6 0 0 0 0 0
3 3 0 6 6 0 0 6 6 3 0 6 0 0 0 0 0 0 0 0 6 0 0 0 0 0 0 0 0 5 0 0 0 0 0 0 0 0 0 0 6 6 0 0 0 0 0 0 0 0 0 0 0 6 0 0 0 0 0 0
3 3 0 0 0 0 0 6 6 0 0 6 0 0 0 0 0 0 0 0 6 0 0 0 5 0 0 0 0 0 0 0 0 0 0 0 5 0 0 6 0 0 0 3 3 0 0 0 6 0 0 7 6 0 0 0 0 0 0 3
4 4 0 0 0 0 0 6 0 0 0 6 6 0 0 6 6 6 0 3 6 0 0 0 0 0 0 0 0 0 0 0 0 0 0 0 0 0 0 6 0 0 0 6 6 6 0 0 6 6 6 6 6 0 0 0 0 0 0 3
4 4 0 0 0 0 0 6 0 0 0 0 0 0 0 0 0 0 0 3 6 0 0 0 0 0 3 3 0 0 0 0 0 3 3 0 0 0 0 6 0 0 0 0 0 0 0 0 0 3 3 3 6 0 0 0 0 0 0 3
4 4 0 0 0 0 0 6 6 0 0 0 0 0 0 0 0 0 0 3 6 0 0 0 0 5 3 3 3 3 3 3 3 3 3 0 0 0 0 6 7 0 0 0 0 0 0 0 0 0 0 3 6 0 0 0 0 0 0 4
4 4 0 0 0 0 0 6 0 0 0 0 0 0 6 0 0 6 6 6 6 0 0 0 0 0 0 3 3 3 3 3 3 3 0 5 0 0 0 6 6 6 6 0 0 6 0 0 6 6 6 6 6 0 0 0 0 0 0 4
0 0 0 0 0 0 0 0 0 0 3 3 0 0 6 0 0 6 0 0 0 0 0 0 0 0 0 3 3 7 7 7 3 3 0 0 0 0 0 0 0 0 0 0 0 6 0 0 6 3 0 0 0 0 0 0 0 0 0 0
0 0 0 9 0 0 0 0 0 0 3 6 0 0 6 3 0 0 0 0 0 0 0 0 0 0 0 3 3 7 7 7 3 3 0 0 0 0 0 0 0 0 0 0 0 6 0 0 6 3 0 0 0 0 0 0 9 0 0 0
4 4 0 0 0 0 0 6 0 0 6 6 0 0 6 3 0 0 0 0 6 0 0 0 0 0 0 3 3 3 3 3 3 3 0 0 0 0 0 6 0 0 6 0 3 6 0 0 6 0 0 6 6 0 0 0 0 0 4 4
4 4 0 0 0 0 0 6 0 0 0 0 0 0 0 0 0 6 6 6 6 0 0 5 0 0 3 3 3 3 3 3 3 3 3 0 0 0 0 6 0 0 6 0 3 3 0 0 6 0 0 6 6 0 0 0 0 0 4 4
4 4 0 0 0 0 0 6 0 0 0 0 0 0 0 0 0 6 0 0 6 0 0 0 0 0 3 3 0 0 0 0 0 3 3 0 5 0 0 6 6 6 6 0 0 0 0 0 0 0 0 6 6 0 0 0 0 0 4 4
3 3 0 0 0 0 0 6 6 7 0 0 0 6 6 0 0 0 0 0 6 0 0 0 0 0 0 0 0 0 0 0 0 0 0 0 0 0 0 6 7 0 0 0 0 0 0 0 0 0 0 6 6 0 0 0 0 0 4 4
3 0 0 0 0 0 0 6 6 6 0 0 0 0 0 0 0 0 0 0 6 0 0 0 0 0 0 0 0 0 0 0 0 5 0 0 0 0 0 6 7 0 0 0 0 0 6 0 0 6 6 6 6 0 0 0 0 0 3 3
0 0 0 0 0 0 0 6 3 0 0 0 0 0 0 0 0 0 0 0 6 0 0 0 0 0 5 0 0 0 0 0 0 0 0 0 0 0 0 6 6 6 6 6 0 0 6 0 0 0 0 0 6 0 0 4 4 0 3 3
0 0 0 0 0 0 0 6 3 0 0 0 0 6 0 0 0 0 0 0 6 7 0 0 0 0 0 0 0 0 0 0 0 0 0 0 0 0 7 6 3 3 3 6 0 0 6 3 0 0 0 0 6 0 0 4 4 0 0 0
0 0 0 0 0 0 0 6 6 6 6 0 0 6 0 0 3 3 0 0 6 7 7 0 0 0 0 0 0 0 0 5 0 0 0 0 0 7 7 6 0 3 3 6 0 0 6 3 0 0 0 3 6 0 0 4 4 0 0 0
0 0 3 3 5 0 0 6 6 0 0 0 0 6 6 0 3 6 0 0 6 6 6 6 6 6 6 6 6 0 0 6 6 6 6 6 6 6 6 6 6 0 0 6 0 0 6 0 0 0 0 3 6 0 0 4 4 4 0 0
9 0 3 3 3 0 0 6 0 0 0 0 0 3 6 0 0 6 0 0 0 0 0 0 0 0 0 6 0 0 0 6 6 7 7 0 0 0 0 0 0 0 0 0 0 0 0 0 0 0 0 3 6 0 0 4 4 4 0 0
0 0 0 3 0 0 0 6 0 0 0 0 0 3 6 0 0 6 0 0 0 0 0 0 0 0 0 6 3 0 0 6 0 0 0 0 0 0 0 0 0 0 0 0 0 0 0 0 0 0 0 0 6 3 0 0 0 0 0 9
0 0 0 0 0 0 0 6 0 3 6 6 0 0 0 0 0 6 6 0 0 0 6 0 0 6 6 6 3 0 6 6 0 0 0 0 0 0 6 6 6 0 0 0 0 0 0 0 0 0 0 0 6 3 0 0 0 0 3 0
0 0 0 0 0 0 0 6 0 3 6 6 0 0 0 0 0 3 3 0 0 0 6 3 0 0 0 6 0 0 0 0 0 0 6 6 0 0 3 3 6 0 0 6 6 6 6 3 0 0 0 0 6 0 0 0 0 0 3 3
0 0 4 4 0 0 0 6 0 0 6 0 0 0 6 0 0 0 0 0 0 0 6 3 0 0 0 0 0 0 0 0 0 0 0 0 0 0 0 0 0 0 0 0 0 0 6 3 0 0 0 0 6 0 0 0 0 5 3 3
0 0 4 4 3 0 0 6 0 0 0 0 0 0 6 0 0 0 0 0 0 0 6 6 6 0 0 0 0 0 0 0 0 0 0 0 0 0 0 0 0 0 0 0 0 0 6 0 0 0 6 6 6 0 0 0 0 3 3 3
0 0 4 4 3 0 0 6 0 0 0 0 0 0 6 0 0 0 0 0 0 0 0 0 0 0 0 6 6 6 0 0 6 0 0 0 0 0 6 0 0 0 6 6 0 0 0 0 0 0 3 3 6 0 0 0 3 3 3 3
0 0 4 4 3 0 0 6 0 0 6 6 0 0 0 0 0 6 6 0 0 0 0 0 0 0 0 6 6 3 0 0 6 0 0 0 0 0 6 0 0 0 0 0 0 0 0 0 0 0 0 3 6 0 0 0 0 0 3 5
0 0 5 3 3 0 0 6 0 0 6 3 0 0 0 0 0 0 6 6 0 0 6 6 0 0 0 6 3 3 0 0 6 6 6 6 0 0 6 6 0 0 0 0 0 0 0 0 0 0 0 0 6 0 0 0 0 0 0 0
0 0 0 0 0 0 0 6 0 0 6 3 0 0 0 0 0 0 0 0 0 0 6 6 0 0 0 0 0 0 0 0 0 0 6 3 0 0 0 0 0 0 0 6 3 3 3 6 0 0 0 0 6 0 0 0 0 0 0 0
0 0 0 0 0 0 0 0 0 0 6 6 0 0 0 6 3 3 3 0 0 0 6 6 7 0 0 0 0 0 0 0 0 0 6 3 0 0 0 0 0 0 7 6 6 6 6 6 0 0 0 0 0 0 0 0 0 0 0 0
3 3 4 4 0 0 0 0 0 0 6 6 6 6 6 6 6 6 6 6 6 6 6 6 6 6 6 6 6 0 0 6 6 6 6 6 6 6 6 6 6 6 6 6 6 6 6 6 6 6 0 0 0 0 0 0 4 4 0 0
3 3 4 4 0 0 0 0 0 0 0 0 0 0 0 0 0 0 0 0 0 0 0 0 0 0 0 0 0 0 0 0 0 0 0 0 0 0 0 0 0 0 0 5 0 0 0 0 0 0 0 0 0 0 0 0 4 4 0 0
3 3 4 4 5 0 0 0 0 0 0 0 0 0 0 0 0 0 0 0 0 0 0 0 0 0 0 0 0 0 0 0 0 0 0 0 0 0 0 0 0 0 0 0 0 0 0 0 0 0 0 0 0 0 0 5 4 4 3 0
3 3 4 4 3 3 0 0 0 3 3 0 0 0 0 3 0 0 0 4 4 4 0 0 0 0 0 0 0 0 0 0 0 0 0 0 0 0 3 5 0 0 0 0 3 3 3 3 0 0 0 0 0 0 3 3 4 4 3 3
3 3 3 3 3 3 3 4 4 0 0 0 0 0 3 3 0 0 0 4 4 4 0 0 0 0 0 0 0 0 0 0 0 0 0 0 0 0 3 3 0 0 0 0 3 4 4 3 3 0 0 0 4 4 3 3 3 3 3 3
3 3 3 3 3 3 3 4 4 4 4 0 0 0 3 3 0 0 0 0 0 0 0 0 0 0 0 0 0 0 0 0 0 0 0 0 0 0 0 0 0 0 0 0 5 4 4 4 3 0 0 0 4 4 3 3 3 3 3 3
3 3 0 0 3 3 3 4 4 4 4 0 0 0 3 3 3 0 0 0 0 0 0 0 0 0 0 0 0 0 0 0 0 0 0 0 0 0 0 0 5 0 0 0 4 4 4 0 0 0 0 4 4 3 3 3 0 0 3 3
3 3 0 0 3 3 3 3 3 3 3 0 0 0 3 3 0 0 0 0 0 0 0 3 3 4 4 4 4 0 0 4 4 3 3 0 0 0 0 0 0 0 0 0 0 0 0 0 0 0 0 3 3 3 3 3 0 0 3 3
3 3 3 3 3 3 3 3 3 0 0 0 0 0 0 0 0 0 0 0 0 0 9 3 3 4 4 4 4 0 0 4 4 4 3 3 0 9 0 0 0 0 0 0 0 0 0 0 0 0 0 0 0 3 3 3 3 3 3 3